about = "情報"
accept = "承諾"
action = "アクション"
actor = "アクター"
albedo_map = "アルベドマップ"
alpha = "アルファ"
alpha_cutoff = "アルファカットオフ"
alpha_factor = "アルファ係数"
alpha_mode = "アルファモード"
alpha_mode_blend = "ブレンド"
alpha_mode_mask = "マスク"
alpha_mode_opaque = "不透明"
ambient_occlusion = "環境オクルージョン"
angle = "角度"
angles = "角度"
animation = "アニメーション"
animations = "アニメーション"
ao_factor = "環境オクルージョン係数"
apply = "適用"
apply_changes = "変更を適用"
arguments = "引数"
attachment = "アタッチメント"
attachments = "アタッチメント"
background_color = "背景色"
blendcontrollers = "ブレンドコントローラー"
bloom = "ブルーム"
blue = "青"
bodygroups = "ボディグループ"
bone = "ボーン"
bones = "ボーン"
brightness = "明るさ"
bruteforce = "暴力"
bsp_and_octree = "BSP + Octree"
cancel = "キャンセル"
candela = "カンデラ"
channel = "チャンネル"
chat = "チャット"
chest = "胸"
class = "クラス"
clear = "クリア"
close = "閉じる"
color = "色"
color_factor = "色係数"
color_mode = "カラーモード"
concave = "凹面"
connect = "接続"
contrast = "コントラスト"
convex = "凸面"
copy = "コピー"
copy_to_clipboard = "クリップボードにコピー"
custom = "カスタム"
data = "データ"
decline = "拒否"
default = "デフォルト"
degree_x = "{0} 度"
detach = "分離"
detailed = "詳細"
disabled = "無効"
duration = "持続時間"
emission_factor = "放射係数"
emission_map = "放射マップ"
emission_strength = "放射強度"
enabled = "有効"
end = "終了"
entities = "エンティティ"
environment = "環境"
euler_pitch = "ピッチ"
euler_roll = "ロール"
euler_yaw = "ヨー"
event = "イベント"
events = "イベント"
explorer_location = "場所"
fast = "高速"
favorites = "お気に入り"
filter = "フィルター"
flex_animation = "フレックスアニメーション"
flex_controllers = "フレックスコントローラー"
flexes = "フレックス"
fps = "FPS"
frame = "フレーム"
gamemode = "ゲームモード"
gameplay = "ゲームプレイ"
gamma_correction = "ガンマ補正"
gear = "ギア"
glossiness = "光沢度"
graphics_api = "グラフィックスAPI"
graphics_api_opengl = "OpenGL"
graphics_api_vulkan = "Vulkan"
green = "緑"
hdrr = "HDRR"
head = "頭"
hex = "16進数"
hitbox = "ヒットボックス"
hitboxes = "ヒットボックス"
hitgroup = "ヒットグループ"
horizontal = "水平"
hsv = "HSV"
hsv_value = "値"
hue = "色相"
icon = "アイコン"
id = "ID"
import = "インポート"
info = "情報"
intensity = "強度"
intensity_unit = "強度単位"
lan_english = "英語"
lan_german = "ドイツ語"
lan_portuguese = "ポルトガル語"
language = "言語"
latency = "遅延"
left = "左"
left_arm = "左腕"
left_leg = "左脚"
localization = "地域化"
loop = "ループ"
lumen = "ルーメン"
map = "マップ"
mass = "質量"
material = "マテリアル"
materials = "マテリアル"
max = "最大"
maximum = "最大"
metallic = "メタリック"
metalness = "金属度"
min = "最小"
minimum = "最小"
mode = "モード"
model = "モデル"
mono = "モノ"
more = "もっと"
more_list = "もっと ({0}/{1})"
motion_blur = "モーションブラー"
movement = "移動"
music = "音楽"
name = "名前"
no = "いいえ"
no_limit = "無制限"
none = "なし"
normal_map = "法線マップ"
not_found = "見つかりませんでした"
npcs = "NPC"
octree = "Octree"
off = "オフ"
offset = "オフセット"
ok = "OK"
origin = "原点"
other = "その他"
password_protected = "PW"
paste = "貼り付け"
paste_from_clipboard = "クリップボードから貼り付け"
path = "パス"
patron = "パトロン"
patrons = "パトロン"
pbr = "PBR"
perspective = "視点"
physics = "物理"
players = "プレイヤー"
position = "位置"
powered_by = "Powered By"
preferences = "設定"
preset = "プリセット"
preview = "プレビュー"
progress = "進行状況"
properties = "プロパティ"
props = "プロップ"
quality = "品質"
radius = "半径"
red = "赤"
refresh = "更新"
remove = "削除"
rename = "名前を変更"
render = "レンダリング"
reset = "リセット"
rgb = "RGB"
right = "右"
right_arm = "右腕"
right_leg = "右足"
rma_map = "RMAマップ"
rotation = "回転"
roughness = "粗さ"
saturation = "彩度"
scale = "スケール"
server_name = "サーバー名"
size = "サイズ"
skeleton = "スケルトン"
skin = "スキン"
skins = "スキン"
specular = "スペキュラー"
speed = "速度"
ssao = "SSAO"
sss_factor = "サブサーフェス・スキャタリング・ファクター"
start = "開始"
stereo = "ステレオ"
stomach = "胃"
surface_material = "表面材質"
symbol_candela = "cd"
symbol_degree = "度"
symbol_lumen = "lm"
symbol_lux = "lx"
symbol_meters = "m"
texture = "テクスチャ"
textures = "テクスチャ"
tonemapping = "トーンマッピング"
tools = "ツール"
tree = "ツリー"
type = "タイプ"
unbound = "バインドされていない"
unknown = "不明"
unsupported_extension = "サポートされていない拡張子"
value = "値"
vehicles = "車両"
version = "バージョン"
vertical = "垂直"
view = "表示"
viewport = "ビューポート"
virtual_reality_abbreviation = "VR"
weapons = "武器"
wetness = "湿度"
windows = "Windows"
wrinkle_compress_map = "シワ圧縮マップ"
wrinkle_stretch_map = "シワ伸ばしマップ"
yes = "はい"
