about = "Über"
accept = "Akzeptieren"
action = "Aktion"
actor = "Akteur"
add_mapping = "Mapping hinzufügen"
albedo_map = "Albedo Map"
alpha = "Alpha"
alpha_cutoff = "Alphaschnittwert"
alpha_cutoff_desc = "Deckkraftschwelle zum Verwerfen von Fragmenten oder Pixeln basierend auf ihren Alphawerten."
alpha_factor = "Alpha Faktor"
alpha_mode = "Alpha Modus"
alpha_mode_blend = "Überblendet"
alpha_mode_mask = "Maskiert"
alpha_mode_opaque = "Lichtundurchlässig"
ambient_occlusion = "Umgebungsokklusion"
angle = "Winkel"
angles = "Winkel"
animation = "Animation"
animations = "Animationen"
ao_factor = "Umgebungsokklusionsfaktor"
apply = "Übernehmen"
apply_changes = "Änderungen übernehmen"
arguments = "Argumente"
attachment = "Ansatz"
attachments = "Ansätze"
author = "Autor"
background_color = "Hintergrundfarbe"
blendcontrollers = "Blend-Kontroller"
bloom = "Bloom"
blue = "Blau"
bodygroups = "Körpergruppen"
bone = "Knochen"
bones = "Knochen"
brightness = "Helligkeit"
bruteforce = "Brute-Force"
bsp_and_octree = "BSP + Octree"
cancel = "Abbrechen"
candela = "Candela"
channel = "Kanal"
chat = "Chat"
chest = "Brust"
class = "Klasse"
clear = "Leeren"
clear_animation_target = "Animationziel löschen"
close = "Schließen"
color = "Farbe"
color_factor = "Farbfaktor"
color_mode = "Farbmodus"
concave = "Konkav"
connect = "Verbinden"
constraints = "Einschränkungen"
contrast = "Kontrast"
controller = "Controller"
convex = "Konvex"
copy = "Kopieren"
copy_to_clipboard = "In Zwischenablage kopieren"
custom = "Benutzerdefiniert"
cut = "Schneiden"
data = "Daten"
debug_lightmap_atlas = "Lightmap Atlas"
debug_lightmap_atlas_view = "Lightmap Atlas Ansicht"
debug_lightmap_diffuse = "Diffuse Lightmap"
debug_lightmap_diffuse_direct = "Diffuse Direkte Lightmap"
debug_lightmap_diffuse_indirect = "Diffuse Indirekte Lightmap"
debug_lightmap_dominant_direction = "Dominant Direction Lightmap"
decline = "Verweigern"
default = "Standard"
degree_x = "{0} Grad"
delete = "Löschen"
detach = "Loslösen"
detailed = "Detailliert"
disabled = "Deaktiviert"
duration = "Dauer"
emission_factor = "Emissionsfaktor"
emission_map = "Emissionsmap"
emission_strength = "Emissionstärke"
enabled = "Aktiviert"
end = "Ende"
entities = "Entities"
environment = "Umgebung"
euler_pitch = "Neigung"
euler_roll = "Rollen"
euler_yaw = "Gier"
evaluation = "Evaluation"
event = "Ereignis"
events = "Ereignisse"
execute = "Ausführen"
exiting = "Beenden..."
explorer_location = "Verzeichnis"
export = "Exportieren"
fast = "Schnell"
favorites = "Favoriten"
filter = "Filter"
flex_animation = "Flex Animation"
flex_controller_limits = "Flex Controller Grenzwerte"
flex_controllers = "Flex Kontroller"
flexes = "Flexes"
flip = "Drehen"
formula = "Formel"
fps = "FPS"
frame = "Frame"
full = "Vollständig"
gamemode = "Spielmodus"
gameplay = "Spielmechanik"
gamma_correction = "Gammakorrektur"
gear = "Ausrüstung"
glossiness = "Glanz"
graphics_api = "Grafik API"
graphics_api_opengl = "OpenGL"
graphics_api_vulkan = "Vulkan"
green = "Grün"
hdrr = "HDRR"
head = "Kopf"
hex = "Hex"
hitbox = "Trefferkasten"
hitboxes = "Trefferkästen"
hitgroup = "Treffergruppe"
horizontal = "Horizontal"
hsv = "HSV"
hsv_value = "Hellwert"
hue = "Farbton"
icon = "Icon"
id = "ID"
import = "Importieren"
info = "Info"
intensity = "Intensität"
intensity_unit = "Intensitätseinheit"
lan_english = "English"
lan_german = "Deutsch"
lan_portuguese = "Portugiesisch"
language = "Sprache"
latency = "Latenzzeit"
layout = "Layout"
left = "Links"
left_arm = "Linker Arm"
left_leg = "Linkes Bein"
license = "Lizenz"
light_unit = "Lichteinheit"
localization = "Lokalisation"
loop = "Schleife"
lumen = "Lumen"
map = "Karte"
mass = "Masse"
material = "Material"
materials = "Materialien"
max = "Max"
maximum = "Maximum"
metallic = "Metallisch"
metalness = "Metallartigkeit"
min = "Min"
minimum = "Minimum"
mirrored = "Gespiegelt"
mode = "Modus"
model = "Modell"
mono = "Mono"
more = "Mehr"
more_list = "Mehr ({0}/{1})"
motion_blur = "Bewegungsunschärfe"
movement = "Bewegung"
music = "Musik"
name = "Name"
no = "Nein"
no_limit = "Kein Limit"
none = "Keine"
normal_map = "Normal Map"
not_found = "Nicht gefunden"
npcs = "NPCs"
octree = "Octree"
off = "Aus"
offset = "Verschiebung"
ok = "OK"
origin = "Ursprung"
other = "Andere"
password_protected = "PW"
paste = "Einfügen"
paste_from_clipboard = "Aus der Zwischenablage einfügen"
path = "Pfad"
patron = "Patron"
patrons = "Patrone"
pbr = "PBR"
perspective = "Perspektive"
physics = "Physik"
players = "Spieler"
position = "Position"
powered_by = "Powered By"
preferences = "Voreinstellungen"
preset = "Voreinstellung"
preview = "Vorschau"
progress = "Fortschritt"
properties = "Eigenschaften"
props = "Props"
quality = "Qualität"
radius = "Radius"
read_only = "Nur lesen"
recent_projects = "Zuletzt geöffnet"
red = "Rot"
redo = "Wiederholen"
refresh = "Aktualisieren"
remove = "Löschen"
rename = "Umbenennen"
render = "Render"
reopen = "Wieder öffnen"
reset = "Zurücksetzen"
rgb = "RGB"
right = "Rechts"
right_arm = "Rechter Arm"
right_leg = "Rechtes Bein"
rma_map = "RMA Map"
rotation = "Rotation"
roughness = "Rauheit"
saturation = "Farbsättigung"
save_copy = "Kopie speichern"
scale = "Skalierung"
server_name = "Server Name"
set_animation_target = "Animationsziel setzen"
settings = "Einstellungen"
size = "Größe"
skeleton = "Skelett"
skin = "Haut"
skins = "Häute"
specular = "Spiegelnd"
speed = "Geschwindigkeit"
ssao = "SSAO"
sss_factor = "Volumenstreuungsfaktor"
start = "Start"
stereo = "Stereo"
stomach = "Bauch"
surface_material = "Oberflächenmaterial"
symbol_candela = "cd"
symbol_degree = "°"
symbol_lumen = "lm"
symbol_lux = "lx"
symbol_meters = "m"
texture = "Textur"
textures = "Texturen"
tonemapping = "Tone Mapping"
tools = "Werkzeuge"
tree = "Baum"
type = "Typ"
unbound = "Nicht gebunden"
undo = "Rückgängig machen"
unknown = "Unbekannt"
unsupported_extension = "Nicht unterstützte Erweiterung"
untitled = "Ohne Titel"
url = "URL"
value = "Wert"
vehicles = "Fahrzeuge"
version = "Version"
vertical = "Vertikal"
view = "Ansicht"
viewport = "Ansichtsfenster"
virtual_reality_abbreviation = "VR"
weapons = "Waffen"
website = "Website"
wetness = "Nässe"
windows = "Fenster"
wrinkle_compress_map = "Falten-Kompressionsmap"
wrinkle_stretch_map = "Falten-Streckungsmap"
yes = "Ja"