about = "Acerca de"
accept = "Aceptar"
action = "Acción"
actor = "Actor"
add_mapping = "Añadir mapeo"
albedo_map = "Mapa de Albedo"
alpha = "Alfa"
alpha_cutoff = "Corte Alfa"
alpha_cutoff_desc = "Umbral de opacidad para descartar fragmentos o píxeles basado en sus valores alfa."
alpha_factor = "Factor Alpha"
alpha_mode = "Modo Alfa"
alpha_mode_blend = "Mezclar"
alpha_mode_mask = "Máscara"
alpha_mode_opaque = "Opaco"
ambient_occlusion = "Oclusión Ambiental"
angle = "Ángulo"
angles = "Ángulos"
animation = "Animación"
animations = "Animaciones"
ao_factor = "Factor de oclusión ambiental"
apply = "Aplicar"
apply_changes = "Aplicar cambios"
arguments = "Argumentos"
attachment = "Adjunto"
attachments = "Adjuntos"
author = "Autor"
background_color = "Color de fondo"
blendcontrollers = "Controladores de mezcla"
bloom = "Resplandor"
blue = "Azul"
bodygroups = "Grupos de cuerpo"
bone = "Hueso"
bones = "Huesos"
brightness = "Brillo"
bruteforce = "Fuerza Bruta"
bsp_and_octree = "BSP + Octree"
cancel = "Cancelar"
candela = "Candela"
channel = "Canal"
chat = "Chat"
chest = "Pecho"
class = "Clase"
clear = "Borrar"
clear_animation_target = "Borrar objetivo de animación"
close = "Cerrar"
color = "Color"
color_factor = "Factor de color"
color_mode = "Modo de color"
concave = "Cóncavo"
connect = "Conectar"
constraints = "Restricciones"
contrast = "Contraste"
controller = "Controlador"
convex = "Convexo"
copy = "Copiar"
copy_to_clipboard = "Copiar al portapapeles"
custom = "Personalizado"
cut = "Cortar"
data = "Datos"
debug_lightmap_atlas = "Atlas de Lightmap"
debug_lightmap_atlas_view = "Vista del Atlas de Lightmap"
debug_lightmap_diffuse = "Mapa de luz difusa"
debug_lightmap_diffuse_direct = "Textura de Luz Directa Difusa"
debug_lightmap_diffuse_indirect = "Mapa de luz difusa indirecta"
debug_lightmap_dominant_direction = "Mapa de luz de dirección dominante"
decline = "Denegar"
default = "Predeterminado"
degree_x = "0 Grado"
delete = "Eliminar"
detach = "Separar"
detailed = "Detallado"
disabled = "Dishabilitar"
duration = "Duración"
emission_factor = "Factor de Emisión"
emission_map = "Mapa de emisión"
emission_strength = "Intensidad de Emisión"
enabled = "Activar"
end = "Fin"
entities = "Entidades"
environment = "Entorno"
euler_pitch = "Inclinación"
euler_roll = "Girar"
euler_yaw = "Giro"
evaluation = "Evaluación"
event = "Evento"
events = "Eventos"
execute = "Ejecutar"
exiting = "Saliendo..."
explorer_location = "Ubicación"
export = "Exportar"
fast = "Rápido"
favorites = "Favoritos"
filter = "Filtro"
flex_animation = "Animación Flex"
flex_controller_limits = "Límites del controlador de flexión"
flex_controllers = "Controladores de flexión"
flexes = "Flexes"
flip = "Voltear"
formula = "Fórmula"
fps = "FPS"
frame = "Marco"
full = "Completo"
gamemode = "Modo de Juego"
gameplay = "Jugabilidad"
gamma_correction = "Corrección Gamma"
gear = "Engranaje"
glossiness = "Brillo"
graphics_api = "API de gráficos"
graphics_api_opengl = "OpenGL"
graphics_api_vulkan = "Vulkan"
green = "Verde"
hdrr = "HDRR"
head = "Cabeza"
hex = "Hexágono"
hitbox = "Hitbox"
hitboxes = "Hitboxes"
hitgroup = "Grupo de impacto"
horizontal = "Horizontal"
hsv = "HSV"
hsv_value = "Valor"
hue = "Matiz"
icon = "Ícono"
id = "ID"
import = "Importar"
info = "Información"
intensity = "Intensidad"
intensity_unit = "Unidad de Intensidad"
lan_english = "Inglés"
lan_german = "Alemán"
lan_portuguese = "Portugués"
language = "Idioma"
latency = "Latencia"
layout = "Diseño"
left = "Izquierda"
left_arm = "Brazo izquierdo"
left_leg = "Pierna izquierda"
license = "Licencia"
light_unit = "Unidad de Luz"
localization = "Localización"
loop = "Bucle"
lumen = "Lumen"
map = "Mapa"
mass = "Masa"
material = "Material"
materials = "Materiales"
max = "Máximo"
maximum = "Máximo"
metallic = "Metálico"
metalness = "Metalness"
min = "Mín."
minimum = "Mínimo"
mirrored = "Reflejado"
mode = "Modo"
model = "Modelo"
mono = "Mono"
more = "Más"
more_list = "Más ({0}/{1})"
motion_blur = "Desenfoque de Movimiento"
movement = "Movimiento"
music = "Música"
name = "Nombre"
no = "No"
no_limit = "Sin límite"
none = "Ninguno"
normal_map = "Mapa de Normales"
not_found = "No encontrado"
npcs = "PNJs"
octree = "Octree"
off = "Apagado"
offset = "Desplazamiento"
ok = "Aceptar"
origin = "Origen"
other = "Otros"
password_protected = "PW"
paste = "Pegar"
paste_from_clipboard = "Pegar desde portapapeles"
path = "Ruta"
patron = "Patrón"
patrons = "Clientes"
pbr = "PBR"
perspective = "Perspectiva"
physics = "Física"
players = "Jugadores"
position = "Posición"
powered_by = "Alimentado por"
preferences = "Preferencias"
preset = "Preconfiguración"
preview = "Vista previa"
progress = "Progreso"
properties = "Propiedades"
props = "Accesorios"
quality = "Calidad"
radius = "Radio"
read_only = "Solo lectura"
recent_projects = "Abrir Reciente"
red = "Rojo"
redo = "Rehacer"
refresh = "Refrescar"
remove = "Eliminar"
rename = "Renombrar"
render = "Render"
reopen = "Reabrir"
reset = "Restablecer"
rgb = "RGB"
right = "Derecha"
right_arm = "Brazo derecho"
right_leg = "Pierna derecha"
rma_map = "Mapa RMA"
rotation = "Rotación"
roughness = "Rugosidad"
saturation = "Saturación"
save_copy = "Guardar Copia"
scale = "Escalar"
server_name = "Nombre de Servidor"
set_animation_target = "Establecer objetivo de animación"
settings = "Configuración"
size = "Tamaño"
skeleton = "Esqueleto"
skin = "Piel"
skins = "Pieles"
specular = "Especular"
speed = "Velocidad"
ssao = "SSAO"
sss_factor = "Factor de Dispersión Subsuperficial"
start = "Comenzar"
stereo = "Estéreo"
stomach = "Estómago"
surface_material = "Material de Superficie"
symbol_candela = "cd"
symbol_degree = "grados"
symbol_lumen = "lm"
symbol_lux = "lx"
symbol_meters = "m"
texture = "Textura"
textures = "Texturas"
tonemapping = "Mapeo de tonos"
tools = "Herramientas"
tree = "Árbol"
type = "Tipo"
unbound = "No vinculado"
undo = "Deshacer"
unknown = "Desconocido"
unsupported_extension = "Extensión no compatible"
untitled = "Sin título"
url = "URL"
value = "Valor"
vehicles = "Vehículos"
version = "Versión"
vertical = "Vertical"
view = "Ver"
viewport = "Vista previa"
virtual_reality_abbreviation = "VR"
weapons = "Armas"
website = "Sitio web"
wetness = "Humedad"
windows = "Ventanas"
wrinkle_compress_map = "Mapa de Compresión de Arrugas"
wrinkle_stretch_map = "Mapa de Estiramiento de Arrugas"
yes = "Sí"