about = "Informazioni"
accept = "Accetta"
action = "Azione"
actor = "Attore"
add_mapping = "Aggiungi Mappatura"
albedo_map = "Mappa Albedo"
alpha = "Alpha"
alpha_cutoff = "Taglio Alpha"
alpha_cutoff_desc = "Soglia opacità per scartare frammenti o pixel in base ai loro valori alfa."
alpha_factor = "Fattore alfa"
alpha_mode = "Modalità Alfa"
alpha_mode_blend = "Miscelare"
alpha_mode_mask = "Maschera"
alpha_mode_opaque = "Opaco"
ambient_occlusion = "Ombra ambientale"
angle = "Angolo"
angles = "Angoli"
animation = "Animazione"
animations = "Animazioni"
ao_factor = "Fattore di Ombreggiatura Ambientale"
apply = "Applica"
apply_changes = "Applica modifiche"
arguments = "Argomenti"
attachment = "Allegato"
attachments = "Allegati"
author = "Autore"
background_color = "Colore di sfondo"
blendcontrollers = "Controller di miscelazione"
bloom = "Fioritura"
blue = "Blu"
bodygroups = "Gruppi di corpo"
bone = "Ossa"
bones = "Ossa"
brightness = "Luminosità"
bruteforce = "Forza bruta"
bsp_and_octree = "BSP + Octree"
cancel = "Annulla"
candela = "Candela"
channel = "Canale"
chat = "Chat"
chest = "Cassa"
class = "Classe"
clear = "Cancella"
clear_animation_target = "Cancella destinazione animazione"
close = "Chiudi"
color = "Colore"
color_factor = "Fattore Colore"
color_mode = "Modalità colore"
concave = "Concavo"
connect = "Collega"
constraints = "Vincoli"
contrast = "Contrasto"
controller = "Controllore"
convex = "Convesso"
copy = "Copia"
copy_to_clipboard = "Copia negli appunti"
custom = "Personalizzato"
cut = "Taglia"
data = "Dati"
debug_lightmap_atlas = "Atlante della mappa di illuminazione"
debug_lightmap_atlas_view = "Vista Atlante della Mappa delle Luci"
debug_lightmap_diffuse = "Diffuse Lightmap"
debug_lightmap_diffuse_direct = "Diffusa Mappa Luce Diretta"
debug_lightmap_diffuse_indirect = "Diffusa Mappa di Illuminazione Indiretta"
debug_lightmap_dominant_direction = "Dominant Direction Lightmap"
decline = "Rifiuta"
default = "Predefinito"
degree_x = "0 Gradi"
delete = "Elimina"
detach = "Separare"
detailed = "Dettagliato"
disabled = "Disabilitato"
duration = "Durata"
emission_factor = "Fattore di emissione"
emission_map = "Mappa di emissione"
emission_strength = "Intensità Emissione"
enabled = "Abilitato"
end = "Fine"
entities = "Entità"
environment = "Ambiente"
euler_pitch = "Passo"
euler_roll = "Rotazione"
euler_yaw = "Imbardata"
evaluation = "Valutazione"
event = "Evento"
events = "Eventi"
execute = "Esegui"
exiting = "Uscita..."
explorer_location = "Posizione"
export = "Esporta"
fast = "Veloce"
favorites = "Preferiti"
filter = "Filtro"
flex_animation = "Animazione flessibile"
flex_controller_limits = "Limiti del controller di flessibilità"
flex_controllers = "Controlli di flessibilità"
flexes = "Flessioni"
flip = "Capovolgi"
formula = "Formula"
fps = "FPS"
frame = "Tela"
full = "Completo"
gamemode = "Modalità di gioco"
gameplay = "Gioco"
gamma_correction = "Correzione Gamma"
gear = "Ingranaggio"
glossiness = "Glossiness"
graphics_api = "API grafica"
graphics_api_opengl = "OpenGL"
graphics_api_vulkan = "Vulkan"
green = "Verde"
hdrr = "HDRR"
head = "Testa"
hex = "Esadecimale"
hitbox = "Hitbox"
hitboxes = "Hitboxes"
hitgroup = "Gruppo di colpo"
horizontal = "Orizzontale"
hsv = "HSV"
hsv_value = "Valore"
hue = "Tonalità"
icon = "Icona"
id = "ID"
import = "Importa"
info = "Informazioni"
intensity = "Intensità"
intensity_unit = "Unità di intensità"
lan_english = "Italiano"
lan_german = "Tedesco"
lan_portuguese = "Portoghese"
language = "Italian"
latency = "Latency"
layout = "Layout"
left = "Sinistra"
left_arm = "Braccio Sinistro"
left_leg = "Gamba sinistra"
license = "Licenza"
light_unit = "Unità di Luce"
localization = "Localizzazione"
loop = "Loop - Ciclo"
lumen = "Lumen"
map = "Mappa"
mass = "Massa"
material = "Materiale"
materials = "Materiali"
max = "Max"
maximum = "Massimo"
metallic = "Metallico"
metalness = "Metallicità"
min = "Min"
minimum = "Minimo"
mirrored = "Specchiato"
mode = "Modalità"
model = "Modello"
mono = "Mono"
more = "Più"
more_list = "Più ({0}/{1})"
motion_blur = "Motion Blur"
movement = "Movimento"
music = "Musica"
name = "Nome"
no = "No"
no_limit = "Nessun limite"
none = "Nessuno"
normal_map = "Mappa normale"
not_found = "Non trovato."
npcs = "PNG"
octree = "Octree"
off = "Spento"
offset = "Offset"
ok = "OK"
origin = "Origine"
other = "Altro"
password_protected = "PW"
paste = "Incolla"
paste_from_clipboard = "Incolla dalla clipboard"
path = "Percorso"
patron = "Patron"
patrons = "Clienti"
pbr = "PBR"
perspective = "Prospettiva"
physics = "Fisica"
players = "Giocatori"
position = "Posizione"
powered_by = "Alimentato da"
preferences = "Preferenze"
preset = "Preset"
preview = "Anteprima"
progress = "Progresso"
properties = "Proprietà"
props = "Oggetti"
quality = "Qualità"
radius = "Raggio"
read_only = "Sola lettura"
recent_projects = "Apri Recenti"
red = "Rosso"
redo = "Rifai"
refresh = "Aggiorna"
remove = "Rimuovi"
rename = "Rinomina"
render = "Render"
reopen = "Riapri"
reset = "Reset"
rgb = "RGB"
right = "Destra"
right_arm = "Braccio destro"
right_leg = "Gamba destra"
rma_map = "Mappa RMA"
rotation = "Rotazione"
roughness = "Rugosità"
saturation = "Saturazione"
save_copy = "Salva Copia"
scale = "Scala"
server_name = "Nome del server"
set_animation_target = "Imposta destinazione animazione"
settings = "Impostazioni"
size = "Dimensione"
skeleton = "Scheletro"
skin = "Pelle"
skins = "Sfumature"
specular = "Speculare"
speed = "Velocità"
ssao = "SSAO"
sss_factor = "Fattore di scattering subsuperficiale"
start = "Inizio"
stereo = "Stereo"
stomach = "Stomaco"
surface_material = "Materiale Superficiale"
symbol_candela = "cd"
symbol_degree = "gradi"
symbol_lumen = "lm"
symbol_lux = "lx"
symbol_meters = "m"
texture = "Texture"
textures = "Testure"
tonemapping = "Mappatura dei toni"
tools = "Strumenti"
tree = "Albero"
type = "Tipo"
unbound = "Non vincolato"
undo = "Annulla"
unknown = "Sconosciuto"
unsupported_extension = "Estensione non supportata"
untitled = "Senza titolo"
url = "URL"
value = "Valore"
vehicles = "Veicoli"
version = "Versione"
vertical = "Verticale"
view = "Vista"
viewport = "Viewport"
virtual_reality_abbreviation = "VR"
weapons = "Armi"
website = "Sito web"
wetness = "Umidità"
windows = "Finestre"
wrinkle_compress_map = "Mappa di Compressione Rughe"
wrinkle_stretch_map = "Mappa di Stiramento delle Rughe"
yes = "Sì"