about = "À propos"
accept = "Accepter"
action = "Action"
actor = "Acteur"
add_mapping = "Ajouter le mappage"
albedo_map = "Carte d'albédo"
alpha = "Alpha"
alpha_cutoff = "Coupe Alpha"
alpha_cutoff_desc = "Seuil d'opacité pour rejeter les fragments ou pixels en fonction de leurs valeurs alpha."
alpha_factor = "Facteur Alpha"
alpha_mode = "Mode Alpha"
alpha_mode_blend = "Mélange"
alpha_mode_mask = "Masque"
alpha_mode_opaque = "Opaque"
ambient_occlusion = "Occlusion ambiante"
angle = "Angle"
angles = "Angles"
animation = "Animation"
animations = "Animations"
ao_factor = "Facteur d'occlusion ambiante"
apply = "Appliquer"
apply_changes = "Appliquer les modifications"
arguments = "Arguments"
attachment = "Pièce jointe"
attachments = "Pièces jointes"
author = "Auteur"
background_color = "Couleur de fond"
blendcontrollers = "Contrôleurs d'association"
bloom = "Flou lumineux"
blue = "Bleu"
bodygroups = "Groupes corporels"
bone = "Os"
bones = "Os"
brightness = "Luminosite"
bruteforce = "Brute-Force"
bsp_and_octree = "BSP + Octree"
cancel = "Annuler"
candela = "Candela"
channel = "Chaîne"
chat = "Tchat"
chest = "Poitrine"
class = "Classe"
clear = "Clair"
clear_animation_target = "Effacer la cible d'animation"
close = "Fermer"
color = "Couleur"
color_factor = "Facteur de couleur"
color_mode = "Mode couleur"
concave = "Concave"
connect = "Connecter"
constraints = "Contraintes"
contrast = "Contraste"
controller = "Contrôleur"
convex = "Convexe"
copy = "Copier"
copy_to_clipboard = "Copier dans le presse-papiers"
custom = "Personnalisé"
cut = "Couper"
data = "Données"
debug_lightmap_atlas = "Atlas de lightmap"
debug_lightmap_atlas_view = "Visualisation de l'atlas de lightmaps"
debug_lightmap_diffuse = "Diffuser Lightmap"
debug_lightmap_diffuse_direct = "Diffuse Direct Lightmap"
debug_lightmap_diffuse_indirect = "Diffuse Indirect Lightmap"
debug_lightmap_dominant_direction = "Carte des ombres de direction dominante"
decline = "Decliner"
default = "Défaut"
degree_x = "0 degré"
delete = "Supprimer"
detach = "Détacher"
detailed = "Détaillé"
disabled = "Desactive"
duration = "Durée"
emission_factor = "Facteur d'émission"
emission_map = "Carte d'émission"
emission_strength = "Force d'émission"
enabled = "Active"
end = "Fin"
entities = "Entités"
environment = "Environnement"
euler_pitch = "Présentation"
euler_roll = "Lancer"
euler_yaw = "Yaw"
evaluation = "Évaluation"
event = "Événement"
events = "Événements"
execute = "Exécuter"
exiting = "Sortie..."
explorer_location = "Emplacement"
export = "Exporter"
fast = "Rapide"
favorites = "Préférés"
filter = "Filtre"
flex_animation = "Animation Flex"
flex_controller_limits = "Limites du contrôleur Flex"
flex_controllers = "Contrôleurs Flex"
flexes = "Se plie"
flip = "Retourner"
formula = "Formule"
fps = "IPS"
frame = "Cadre"
full = "Complet"
gamemode = "Mode de jeu"
gameplay = "Jouabilité"
gamma_correction = "Correction gamma"
gear = "Engrenage"
glossiness = "Brillance"
graphics_api = "API graphique"
graphics_api_opengl = "OpenGL"
graphics_api_vulkan = "Vulkan"
green = "Vert"
hdrr = "HDRR"
head = "Tête"
hex = "Hexagon"
hitbox = "Hitbox"
hitboxes = "Hitboxes"
hitgroup = "Hitgroup"
horizontal = "Horizontal"
hsv = "HSV"
hsv_value = "Valeur"
hue = "Teinte"
icon = "Icône"
id = "ID"
import = "Importer"
info = "Info"
intensity = "Intensité"
intensity_unit = "Unité d'intensité"
lan_english = "Anglais"
lan_german = "Allemand"
lan_portuguese = "portugais"
language = "Langage"
latency = "Latence"
layout = "Disposition"
left = "Gauche"
left_arm = "Bras gauche"
left_leg = "Jambe gauche"
license = "Licence"
light_unit = "Unité de lumière"
localization = "Localisation"
loop = "Boucle"
lumen = "Lumen"
map = "Carte"
mass = "Messe"
material = "Matériel"
materials = "Matériaux"
max = "Max"
maximum = "Maximum"
metallic = "Métallique"
metalness = "Métallique"
min = "Moins"
minimum = "Minimum"
mirrored = "Refleté"
mode = "Mode"
model = "Modèle"
mono = "Mono"
more = "Plus"
more_list = "Plus ({0}/{1})"
motion_blur = "Flou de Mouvement"
movement = "Mouvement"
music = "Musique"
name = "Nom"
no = "Non"
no_limit = "Pas de limite"
none = "Aucun"
normal_map = "Carte normale"
not_found = "Introuvable"
npcs = "PNJ"
octree = "Octree"
off = "Eteint"
offset = "Décalage"
ok = "OK"
origin = "Origine"
other = "Autres"
password_protected = "MDP"
paste = "Coller"
paste_from_clipboard = "Coller à partir du presse-papiers"
path = "Chemin"
patron = "Client"
patrons = "Clients"
pbr = "PBR"
perspective = "Perspective"
physics = "Physique"
players = "Joueurs"
position = "Position"
powered_by = "Propulsé par"
preferences = "Préférences"
preset = "Préréglage"
preview = "Aperçu"
progress = "Progrès"
properties = "Propriétés"
props = "Accessoires"
quality = "Qualité"
radius = "Rayon"
read_only = "Lecture seule"
recent_projects = "Ouvrir Récemment"
red = "Rouge"
redo = "Refaire"
refresh = "Rafraichir"
remove = "Supprimer"
rename = "Renommer"
render = "Rendre"
reopen = "Rouvrir"
reset = "Réinitialiser"
rgb = "RGB"
right = "Droite"
right_arm = "Bras droit"
right_leg = "Jambe droite"
rma_map = "Carte RMA"
rotation = "Rotation"
roughness = "Rugosité"
saturation = "Saturation"
save_copy = "Enregistrer Copie"
scale = "Échelle"
server_name = "Nom du serveur"
set_animation_target = "Définir la cible de l'animation"
settings = "Paramètres"
size = "Taille"
skeleton = "Skeleton"
skin = "Peau"
skins = "Peaux"
specular = "Spéculaire"
speed = "Vitesse"
ssao = "SSAO"
sss_factor = "Facteur de diffusion sous-surface"
start = "Début"
stereo = "Stéréo"
stomach = "Estomac"
surface_material = "Matériau de surface"
symbol_candela = "cd"
symbol_degree = "degrés"
symbol_lumen = "lm (No translation available)"
symbol_lux = "il"
symbol_meters = "m"
texture = "Texture"
textures = "Textures"
tonemapping = "Cartographie des tons"
tools = "Outils"
tree = "Arbre"
type = "Taper"
unbound = "Non lié"
undo = "Annuler"
unknown = "Inconnu"
unsupported_extension = "Extension non prise en charge"
untitled = "Sans titre"
url = "URL"
value = "Valeur"
vehicles = "Véhicules"
version = "Version"
vertical = "Vertical"
view = "Voir"
viewport = "Affichage"
virtual_reality_abbreviation = "RV"
weapons = "Armes"
website = "Site web"
wetness = "Humidité"
windows = "Windows"
wrinkle_compress_map = "Carte de compression des rides"
wrinkle_stretch_map = "Carte des rides et des étirements"
yes = "Oui"