about = "关于"
accept = "接受"
action = "操作"
actor = "演员 (Yǎnyuán)"
add_mapping = "添加映射 (Tiānjiā yìngpíng)"
albedo_map = "反照率贴图"
alpha = "透明度 (Tòumíngdù)"
alpha_cutoff = "Alpha Cutoff"
alpha_cutoff_desc = "基于alpha值丢弃片段或像素的不透明度阈值。"
alpha_factor = "Alpha 因子"
alpha_mode = "α模式"
alpha_mode_blend = "混合"
alpha_mode_mask = "掩蔽"
alpha_mode_opaque = "不透明"
ambient_occlusion = "环境光遮蔽"
angle = "角度"
angles = "角度 (Jiǎodù)"
animation = "动画"
animations = "动画"
ao_factor = "环境遮蔽因子 (Huánjìng zhēmiè yīnzi)"
apply = "应用"
apply_changes = "应用更改"
arguments = "参数"
attachment = "附件 (Fùjiàn)"
attachments = "附件"
author = "作者"
background_color = "背景颜色"
blendcontrollers = "混合控制器"
bloom = "盛开"
blue = "蓝色"
bodygroups = "身体组"
bone = "骨架"
bones = "骨骼"
brightness = "亮度"
bruteforce = "蛮力"
bsp_and_octree = "BSP + 八叉树"
cancel = "取消"
candela = "坎德拉"
channel = "通道 (Tōngdào)"
chat = "聊天"
chest = "胸部 (Xiōng bù)"
class = "类"
clear = "清除"
clear_animation_target = "清除动画目标"
close = "关闭"
color = "颜色"
color_factor = "颜色因子"
color_mode = "颜色模式"
concave = "凹面"
connect = "连接"
constraints = "约束"
contrast = "对比"
controller = "控制器"
convex = "凸出"
copy = "复制"
copy_to_clipboard = "复制到剪贴板"
custom = "定制"
cut = "剪切"
data = "数据"
debug_lightmap_atlas = "光照图集"
debug_lightmap_atlas_view = "光照图集视图"
debug_lightmap_diffuse = "漫反射光照贴图"
debug_lightmap_diffuse_direct = "漫反射直接光照贴图"
debug_lightmap_diffuse_indirect = "漫反射间接光照图"
debug_lightmap_dominant_direction = "主导方向光照图"
decline = "拒绝"
default = "默认"
degree_x = "{0} 度"
delete = "删除"
detach = "分离"
detailed = "详细"
disabled = "禁用"
duration = "持续时间"
emission_factor = "排放因子"
emission_map = "发射贴图"
emission_strength = "发射强度"
enabled = "启用"
end = "结束"
entities = "实体"
environment = "环境"
euler_pitch = "倾斜角度"
euler_roll = "滚动"
euler_yaw = "偏航 (Piān háng)"
evaluation = "评估"
event = "事件"
events = "事件"
execute = "执行"
exiting = "退出..."
explorer_location = "位置 (Wèizhì)"
export = "导出"
fast = "快速"
favorites = "收藏夹"
filter = "过滤器"
flex_animation = "弹性动画"
flex_controller_limits = "弹性控制器限制"
flex_controllers = "弯曲控制器"
flexes = "弯曲"
flip = "翻转"
formula = "公式"
fps = "FPS"
frame = "帧"
full = "全部"
gamemode = "游戏模式"
gameplay = "游戏玩法"
gamma_correction = "Gamma校正"
gear = "齿轮 (Chǐlún)"
glossiness = "光泽度"
graphics_api = "图形 API"
graphics_api_opengl = "OpenGL"
graphics_api_vulkan = "Vulkan"
green = "绿色"
hdrr = "高动态范围渲染"
head = "头"
hex = "十六进制"
hitbox = "碰撞箱"
hitboxes = "碰撞箱"
hitgroup = "命中组"
horizontal = "水平"
hsv = "HSV"
hsv_value = "数值"
hue = "色相"
icon = "图标"
id = "ID"
import = "导入"
info = "信息"
intensity = "强度"
intensity_unit = "强度单位"
lan_english = "\"Chinese (Simplified):"
lan_german = "德语"
lan_portuguese = "葡萄牙语"
language = "语言"
latency = "延迟"
layout = "布局"
left = "左"
left_arm = "左臂"
left_leg = "左腿"
license = "许可证 (Xǔkězhèng)"
light_unit = "光单位"
localization = "本地化"
loop = "循环"
lumen = "亮度"
map = "地图"
mass = "质量"
material = "材料"
materials = "材料"
max = "最大"
maximum = "最大值"
metallic = "金属质感"
metalness = "金属度"
min = "最小"
minimum = "最小"
mirrored = "镜像"
mode = "模式"
model = "模型"
mono = "单声道"
more = "更多 (Gèng duō)"
more_list = "更多（{0}/{1}）"
motion_blur = "运动模糊"
movement = "运动"
music = "音乐"
name = "名称"
no = "没有"
no_limit = "没有限制"
none = "无"
normal_map = "法线贴图"
not_found = "未找到"
npcs = "NPCs"
octree = "八叉树"
off = "关闭"
offset = "偏移"
ok = "确定"
origin = "原点"
other = "其他"
password_protected = "密码"
paste = "粘贴"
paste_from_clipboard = "从剪贴板粘贴"
path = "路径 (Lù jìng)"
patron = "顾客"
patrons = "顾客"
pbr = "PBR"
perspective = "透视"
physics = "物理"
players = "玩家"
position = "位置 (Wèizhì)"
powered_by = "由 {Powered By} 提供"
preferences = "首选项"
preset = "预设"
preview = "预览"
progress = "进度"
properties = "属性"
props = "道具"
quality = "质量 (zhì liàng)"
radius = "半径"
read_only = "只读"
recent_projects = "打开最近"
red = "红色"
redo = "重做"
refresh = "刷新"
remove = "删除"
rename = "重命名"
render = "渲染"
reopen = "重新打开"
reset = "重置"
rgb = "RGB"
right = "正确"
right_arm = "右臂 (Yòu bì)"
right_leg = "右腿"
rma_map = "RMA 地图"
rotation = "旋转 (Xuanzhuan)"
roughness = "粗糙度"
saturation = "饱和度 (Bǎohédù)"
save_copy = "保存副本"
scale = "缩放"
server_name = "服务器名称"
set_animation_target = "设置动画目标"
settings = "设置"
size = "大小"
skeleton = "骨架"
skin = "皮肤"
skins = "皮肤"
specular = "镜面反射"
speed = "速度"
ssao = "屏幕空间环境光遮蔽 (SSAO)"
sss_factor = "次表面散射因子"
start = "开始"
stereo = "立体"
stomach = "胃"
surface_material = "表面材质"
symbol_candela = "cd"
symbol_degree = "度"
symbol_lumen = "导入"
symbol_lux = "轴线"
symbol_meters = "m"
texture = "纹理"
textures = "纹理"
tonemapping = "色调映射 (Sèdiào yìngshè)"
tools = "工具"
tree = "树"
type = "类型"
unbound = "未绑定"
undo = "撤销"
unknown = "未知"
unsupported_extension = "不支持的扩展名"
untitled = "未命名"
url = "URL"
value = "值 (zhòng)"
vehicles = "车辆"
version = "版本"
vertical = "垂直 (Chuízhí)"
view = "视图"
viewport = "视口"
virtual_reality_abbreviation = "VR"
weapons = "武器"
website = "网站"
wetness = "湿润度"
windows = "窗口"
wrinkle_compress_map = "皱纹压缩图"
wrinkle_stretch_map = "皱纹拉伸图"
yes = "是的"