about = "About"
accept = "Accept"
action = "Action"
actor = "Actor"
albedo_map = "Albedo Map"
alpha = "Alpha"
alpha_cutoff = "Alpha Cutoff"
alpha_factor = "Alpha Factor"
alpha_mode = "Alpha Mode"
alpha_mode_blend = "Blend"
alpha_mode_mask = "Mask"
alpha_mode_opaque = "Opaque"
ambient_occlusion = "Ambient Occlusion"
angle = "Angle"
angles = "Angles"
animation = "Animation"
animations = "Animations"
ao_factor = "Ambient Occlusion Factor"
apply = "Apply"
apply_changes = "Apply changes"
arguments = "Arguments"
attachment = "Attachment"
attachments = "Attachments"
background_color = "Background Color"
blendcontrollers = "Blend controllers"
bloom = "Bloom"
blue = "Blue"
bodygroups = "Body groups"
bone = "Bone"
bones = "Bones"
brightness = "Brightness"
bruteforce = "Brute-Force"
bsp_and_octree = "BSP + Octree"
cancel = "Cancel"
candela = "Candela"
channel = "Channel"
chat = "Chat"
chest = "Chest"
class = "Class"
clear = "Clear"
close = "Close"
color = "Color"
color_factor = "Color Factor"
color_mode = "Color Mode"
concave = "Concave"
connect = "Connect"
contrast = "Contrast"
convex = "Convex"
copy = "Copy"
copy_to_clipboard = "Copy to clipboard"
custom = "Custom"
data = "Data"
decline = "Decline"
default = "Default"
degree_x = "{0} Degree"
detach = "Detach"
detailed = "Detailed"
disabled = "Disabled"
duration = "Duration"
emission_factor = "Emission Factor"
emission_map = "Emission Map"
emission_strength = "Emission Strength"
enabled = "Enabled"
end = "End"
entities = "Entities"
environment = "Environment"
euler_pitch = "Pitch"
euler_roll = "Roll"
euler_yaw = "Yaw"
event = "Event"
events = "Events"
explorer_location = "Location"
fast = "Fast"
favorites = "Favorites"
filter = "Filter"
flex_animation = "Flex Animation"
flex_controllers = "Flex Controllers"
flexes = "Flexes"
fps = "FPS"
frame = "Frame"
gamemode = "Game Mode"
gameplay = "Gameplay"
gamma_correction = "Gamma Correction"
gear = "Gear"
glossiness = "Glossiness"
graphics_api = "Graphics API"
graphics_api_opengl = "OpenGL"
graphics_api_vulkan = "Vulkan"
green = "Green"
hdrr = "HDRR"
head = "Head"
hex = "Hex"
hitbox = "Hitbox"
hitboxes = "Hitboxes"
hitgroup = "Hitgroup"
horizontal = "Horizontal"
hsv = "HSV"
hsv_value = "Value"
hue = "Hue"
icon = "Icon"
id = "ID"
import = "Import"
info = "Info"
intensity = "Intensity"
intensity_unit = "Intensity Unit"
lan_english = "English"
lan_german = "Deutsch"
lan_portuguese = "Portuguese"
language = "Language"
latency = "Latency"
left = "Left"
left_arm = "Left Arm"
left_leg = "Left Leg"
localization = "Localization"
loop = "Loop"
lumen = "Lumen"
map = "Map"
mass = "Mass"
material = "Material"
materials = "Materials"
max = "Max"
maximum = "Maximum"
metallic = "Metallic"
metalness = "Metalness"
min = "Min"
minimum = "Minimum"
mode = "Mode"
model = "Model"
mono = "Mono"
more = "More"
more_list = "More ({0}/{1})"
motion_blur = "Motion Blur"
movement = "Movement"
music = "Music"
name = "Name"
no = "No"
no_limit = "No Limit"
none = "None"
normal_map = "Normal Map"
not_found = "Not found"
npcs = "NPCs"
octree = "Octree"
off = "Off"
offset = "Offset"
ok = "OK"
origin = "Origin"
other = "Other"
password_protected = "PW"
paste = "Paste"
paste_from_clipboard = "Paste from clipboard"
path = "Path"
patron = "Patron"
patrons = "Patrons"
pbr = "PBR"
perspective = "Perspective"
physics = "Physics"
players = "Players"
position = "Position"
powered_by = "Powered By"
preferences = "Preferences"
preset = "Preset"
preview = "Preview"
progress = "Progress"
properties = "Properties"
props = "Props"
quality = "Quality"
radius = "Radius"
red = "Red"
refresh = "Refresh"
remove = "Remove"
rename = "Rename"
render = "Render"
reset = "Reset"
rgb = "RGB"
right = "Right"
right_arm = "Right Arm"
right_leg = "Right Leg"
rma_map = "RMA Map"
rotation = "Rotation"
roughness = "Roughness"
saturation = "Saturation"
scale = "Scale"
server_name = "Server Name"
size = "Size"
skeleton = "Skeleton"
skin = "Skin"
skins = "Skins"
specular = "Specular"
speed = "Speed"
ssao = "SSAO"
sss_factor = "Subsurface Scattering Factor"
start = "Start"
stereo = "Stereo"
stomach = "Stomach"
surface_material = "Surface Material"
symbol_candela = "cd"
symbol_degree = "deg"
symbol_lumen = "lm"
symbol_lux = "lx"
symbol_meters = "m"
texture = "Texture"
textures = "Textures"
tonemapping = "Tone mapping"
tools = "Tools"
tree = "Tree"
type = "Type"
unbound = "Not bound"
unknown = "Unknown"
unsupported_extension = "Unsupported extension"
value = "Value"
vehicles = "Vehicles"
version = "Version"
vertical = "Vertical"
view = "View"
viewport = "Viewport"
virtual_reality_abbreviation = "VR"
weapons = "Weapons"
wetness = "Wetness"
windows = "Windows"
wrinkle_compress_map = "Wrinkle Compress Map"
wrinkle_stretch_map = "Wrinkle Stretch Map"
yes = "Yes"