about = "O programie"
accept = "Akceptuj"
action = "Akcja"
actor = "Aktor"
add_mapping = "Dodaj mapowanie"
albedo_map = "Mapa albedo"
alpha = "Alfa"
alpha_cutoff = "Próg alfa"
alpha_cutoff_desc = "Próg przezroczystości do odrzucania fragmentów lub pikseli na podstawie ich wartości alfa."
alpha_factor = "Współczynnik Alpha"
alpha_mode = "Tryb Alpha"
alpha_mode_blend = "Mieszanka"
alpha_mode_mask = "Mask"
alpha_mode_opaque = "Nieprzezroczysty"
ambient_occlusion = "Okluzja otoczenia"
angle = "Kąt"
angles = "Kąty"
animation = "Animacja"
animations = "Animacje"
ao_factor = "Współczynnik oświetlenia otoczenia"
apply = "Zastosuj"
apply_changes = "Zastosuj zmiany"
arguments = "Argumenty"
attachment = "Załącznik"
attachments = "Załączniki"
author = "Autor"
background_color = "Kolor tła"
blendcontrollers = "Kontrolery mieszania"
bloom = "kwiatostan"
blue = "Niebieski"
bodygroups = "Grupy ciała"
bone = "Kość"
bones = "Kość."
brightness = "Jasność"
bruteforce = "Brute-Force"
bsp_and_octree = "BSP + Octree"
cancel = "Anuluj"
candela = "Candela"
channel = "Kanał"
chat = "Czat"
chest = "Skrzynia"
class = "Klasa"
clear = "Wyczyść"
clear_animation_target = "Wyczyść cel animacji"
close = "Zamknij"
color = "Kolor"
color_factor = "Współczynnik koloru"
color_mode = "Tryb koloru"
concave = "Wklęsły"
connect = "Połącz"
constraints = "Ograniczenia"
contrast = "Kontrast"
controller = "Kontroler"
convex = "Wypukły"
copy = "Kopiuj"
copy_to_clipboard = "Skopiuj do schowka"
custom = "Niestandardowy"
cut = "Wyciąć"
data = "Dane"
debug_lightmap_atlas = "Atlas światła"
debug_lightmap_atlas_view = "Widok atlasu mapy światła"
debug_lightmap_diffuse = "Mapa światła rozproszonego"
debug_lightmap_diffuse_direct = "Mapa światła rozproszonego bezpośrednio"
debug_lightmap_diffuse_indirect = "Diffuse Indirect Lightmap"
debug_lightmap_dominant_direction = "Dominująca mapa kierunku światła"
decline = "Odmów"
default = "Domyślny"
degree_x = "{0} Stopień"
delete = "Usuń"
detach = "Odłącz"
detailed = "Szczegółowy"
disabled = "Wyłączony"
duration = "Czas trwania"
emission_factor = "Współczynnik emisji"
emission_map = "Mapa emisji"
emission_strength = "Siła emisji"
enabled = "Włączone"
end = "Koniec"
entities = "Encje"
environment = "Środowisko"
euler_pitch = "Tona"
euler_roll = "Rotacja"
euler_yaw = "Yaw"
evaluation = "Ocena"
event = "Wydarzenie"
events = "Wydarzenia"
execute = "Wykonaj"
exiting = "Wychodzenie..."
explorer_location = "Lokalizacja"
export = "Eksportuj"
fast = "Szybko"
favorites = "Ulubione"
filter = "Filtr"
flex_animation = "Animacja deformacji"
flex_controller_limits = "Ograniczenia kontrolera elastycznego"
flex_controllers = "Kontrolery elastyczne"
flexes = "Ekspresje"
flip = "Obróć"
formula = "Formula"
fps = "klatki na sekundę"
frame = "Rama"
full = "Pełny"
gamemode = "Tryb gry"
gameplay = "Rozgrywka"
gamma_correction = "Korekta gamma"
gear = "Koło zębate"
glossiness = "Połysk"
graphics_api = "API graficzne"
graphics_api_opengl = "OpenGL"
graphics_api_vulkan = "Vulkan"
green = "Zielony"
hdrr = "HDRR"
head = "Głowa"
hex = "Sześciokąt"
hitbox = "Hitbox"
hitboxes = "Hitboksy"
hitgroup = "Grupa uderzeń"
horizontal = "Poziomy"
hsv = "HSV"
hsv_value = "Wartość"
hue = "Odcień"
icon = "Ikona"
id = "ID"
import = "Importuj"
info = "Informacje"
intensity = "Intensywność"
intensity_unit = "Jednostka intensywności"
lan_english = "Polish"
lan_german = "Niemiecki"
lan_portuguese = "Portugalski"
language = "język"
latency = "Opóźnienie"
layout = "Układ"
left = "Lewa"
left_arm = "Lewe ramię"
left_leg = "Lewa Noga"
license = "Licencja"
light_unit = "Jednostka światła"
localization = "Lokalizacja"
loop = "Pętla"
lumen = "Lumen"
map = "Mapa"
mass = "Masa"
material = "Materiał"
materials = "Materiały"
max = "Maks"
maximum = "Maksimum"
metallic = "Metaliczny"
metalness = "Metaliczność"
min = "Min"
minimum = "Minimum"
mirrored = "Odbicie"
mode = "Tryb"
model = "Model"
mono = "Mono"
more = "Więcej"
more_list = "Więcej ({0}/{1})"
motion_blur = "Rozmycie ruchu"
movement = "Ruch"
music = "Muzyka"
name = "Nazwa"
no = "Nie"
no_limit = "Bez ograniczeń"
none = "Brak"
normal_map = "Mapa normalnych"
not_found = "Nie znaleziono"
npcs = "NPCs"
octree = "Octree"
off = "Wyłącz"
offset = "Przesunięcie"
ok = "OK"
origin = "Pochodzenie"
other = "Inny"
password_protected = "PW"
paste = "Wklej"
paste_from_clipboard = "Wklej z schowka"
path = "Ścieżka"
patron = "Patron"
patrons = "Patroni"
pbr = "PBR"
perspective = "Perspektywa"
physics = "Fizyka"
players = "Gracze"
position = "Pozycja"
powered_by = "Napędzane przez"
preferences = "Preferencje"
preset = "Przełącznik"
preview = "Podgląd"
progress = "Postęp"
properties = "Właściwości"
props = "Rekwizyty"
quality = "Jakość"
radius = "Promień"
read_only = "Tylko do odczytu"
recent_projects = "Otwórz ostatnie."
red = "Czerwony"
redo = "Powtórz"
refresh = "Odśwież"
remove = "Usuń"
rename = "Zmień nazwę"
render = "Render"
reopen = "Otwórz ponownie"
reset = "Reset"
rgb = "RGB"
right = "Prawo"
right_arm = "Prawa ręka"
right_leg = "Prawa noga"
rma_map = "Mapa RMA"
rotation = "Obrót"
roughness = "Chropowatość"
saturation = "Nasycenie"
save_copy = "Zapisz kopię"
scale = "Skala"
server_name = "Nazwa Serwera"
set_animation_target = "Ustaw cel animacji"
settings = "Ustawienia"
size = "Rozmiar"
skeleton = "Szkielet"
skin = "Skóra"
skins = "Skórki"
specular = "Specular"
speed = "Prędkość"
ssao = "SSAO"
sss_factor = "Współczynnik Rozpraszania Podpowierzchniowego"
start = "Rozpocznij"
stereo = "Stereo"
stomach = "Żołądek"
surface_material = "Powierzchniowy Materiał"
symbol_candela = "cd"
symbol_degree = "deg"
symbol_lumen = "lm"
symbol_lux = "lx"
symbol_meters = "m"
texture = "Tekstura"
textures = "Tekstury"
tonemapping = "Tone mapping"
tools = "Narzędzia"
tree = "Drzewo"
type = "Typ"
unbound = "Nieprzypisany"
undo = "Cofnij"
unknown = "Nieznane"
unsupported_extension = "Nieobsługiwane rozszerzenie"
untitled = "Bez nazwy"
url = "URL"
value = "Wartość"
vehicles = "Pojazdy"
version = "Wersja"
vertical = "Pionowy"
view = "Widok"
viewport = "Widok"
virtual_reality_abbreviation = "VR"
weapons = "Bronie"
website = "Strona internetowa"
wetness = "Wilgotność"
windows = "Okna"
wrinkle_compress_map = "Mapa skurczu zmarszczek"
wrinkle_stretch_map = "Mapa rozciągania zmarszczek"
yes = "Tak"